||                                                                                                                                          ||
||                                                                                                                                          ||
||                                                                                                                                          ||
||                                                                                                                                          ||
||                                                                                                                                          ||
||                                                                                                                                          ||
||                                                                                                                                          ||
||                                                                                                                                          ||
||                                                                                                                                          ||
||                                                                                                                                          ||
||                                                                                                                                          ||
||                                                                                                                                          ||
||                                                                                                                                          ||
||                                                                                                                                          ||
||                                                                                                                                          ||
||                                                                                                                                          ||
||                                                                                                                                          ||
||                                                                                                                                          ||
||                                                          ====                                                                            ||
||              ------        ------        ---------       ....         ====            ====                                               ||
||              ......        ......        .........       ....         ....            ....                                               ||
||              ......        ......        .........       ====         ....            ....                                               ||
||              ......        ......        .........                    ====            ====                                               ||
||              ......        ......        .........                                                                                       ||
||           --------------   ......        .........                                                                                       ||
||           ..............   ......        .........                                                                                       ==
||           ..............   ......        .........                                                 ====
||           ..............   ......        .........                                                 ....
||           ..............   ......        .........                                                 ....
||   =========================......  =========......  =========                                      ====                                  ==
||   |||||||||||||||||||||||||......  |=======|......  |=======|                                                                            ||
||   |||||||||||||||||||||||||......  |=======|......  |=======|                                                                            ||
||   |||||||||||||||||||||||||......  |=======|......  |=======|                                                                        ----||
||   |||||||||||||||||||||||||......  |=======|......  |=======|        =========        =========                                      ....||
||   |||||||||||||||||||||||||......  ||=====||......  ||=====||        =========        ||=====||                                      ....||
||   |||||||||||||||||||||||||......  ||=====||......  ||=====||        '''''''''        ||=====||                                  --------||
||   |||||||||||||||||||||||||......  ||=====||......  ||=====||        '''''''''  ----  ||=====||                                  ........||
||   |||||||||||||||||||||||||......  ||=====||......  ||=====||        '''''''''  ....  ||=====||                                  ........||
||   |||||||||||||||||||||||||......  |||===|||......  |||===|||        =========  ....  |||===|||                         -------------....||
||   ||||||||||||||||||||=====......  |||===|||......  =========      ==|||===|||  ....  |||===|||          --------       .................||
||   ||||||||||||||||||||'''''......  =========......  '''''''''    ==..|||===|||  ....  |||===|||          ........       .................||
||   |||||||||||||||====='''''......  '''''''''......  '''''''''  ==....|||===|||  ....  |||===|||          ........       .................||
||   |||||||||||||||''''''''''......  '''''''''......  '''''''''==......||||=||||  ....  ||||=||||          ........       .................||
||   ===============''''''''''......  '''''''''......  =========........||||=||||  ....  ||||=||||          .. .. ..       .................||
||   ''''''''''''''''''''=====......  =========......  ||||=||||........||||=||||  ....  ||||=||||          ........       .................||
||   ''''''''''''''''''''|||||......  ||||=||||......  ||||=||||........||||=||||  ....  ||||=||||          ........       .................||
||   '''''''''''''''=====|||||......  ||||=||||......  ||||=||||........||||=||||  ....  ||||=||||          ........       .................||
||==================||||||||||......  ||||=||||......  ||||=||||........||||=||||  ....  ||||=||||          ........       .................||
||||||||||||||||||||||||||||||^^^^^^^^||||=||||^^^^^^^^||||=||||........||||=||||^^^^^^^^||||=||||^^^^^^^^^^^^^^^^^^^^^^^^^^^^^^^^^^^^^^^^^^||
||||||||||||||||||||||||||||||||||||||||||||||||||||||||||||||||||||||||||||||||||||||||||||||||||||||||||||||||||||||||||||||||||||||||||||||